111111111111111111111
1P0000C000000C00000E1
111010C01011101111101
1C00010001010000C0001
101110100010101110111
10C000001000100000001
101111111011111111001
1000000000001000000C1
101111011111111110101
1000000C000C0000C0001
111111111111111111111
