111111111111111111111111
100000000000000000000001
100000011000000000000001
100000101000000000000001
100001111110000000000001
10001000100000000E000001
100000000000000000000001
100000000000000000000001
100000000000000000000001
100000000000000000000001
100000000000000000000001
100000000000000000000001
100000000000000000000001
111111111111111111111111
