1111111111111111111111111111111
1CCCCCCCCCCCCCCCCCCCCCCCCCCCCC1
1CCCCCCCCCCCCCCCCCCCCCCCCCCCCC1
1CCCCCCCCCCCCCCCCCCCCCCCCCCCCC1
1CCCCCCCCC111CCCCCC11111111CCC1
1CCCCCCCC111CCCCCC111CCCC111CC1
1CCCCCC111C111CCCCCCCCC111CCCC1
1CCCC111CC111CCCCCCC111CCCCCCC1
1CC111111111111CCC111CCCCCCCCC1
1CCCCCCC111CCCC111CCCCCCCCCCCC1
1CCCCCC111CCC11111111111CCCCCC1
1CCCCCCCCCCCCCCCCCCCCCCCCCCCCC1
1CCCCCCCCCCCCCCCCCCCCCECCCCCCC1
1111111111111111111111111111111
