1111111111111
1P0010C0000E1
100000C000001
1111111111111