1111111111111
100C0000000E1
1010101010101
1000000000P01
1101010101011
1P00000000001
1111111111111