1111111111111
1P01000010001
1000100100001
1000CCCC00001
1000CCCC00001
1000000000001
10CCC000CCC01
10CCC000CCCE1
1111111111111
