1111111111111
1000000000001
10111000000E1
1000000000P01
1111111111111