1111111111111
100C00E000001
1010101010101
100C00000CP01
1101010101011
1P000C000C001
1111111111111