11111111111111111
1000C00000000C001
100P0C00E00000001
1001C111111111001
10010110100011001
1001C110111101001
10010C00100001001
1001111C101111001
10011110110001001
1001111C111111001
10000000000000001
10000000000000001
11111111111111111
