111111111111111
1P0000000001001
1000010C00000E1
111111111111111
