111111111111111111111111111
1P0000000010000000000000001
100000000010000000000000001
100000000010000000000000001
1000000000000001101001000C1
1C0000000110000000111100001
100000000010000000100100001
100000000010000000100000001
1E000000001000C000000000001
111111111111111111111111111
